111111111111111111111 xx11111111111111111
1       1              xxxxx1  xxxxx1   1
1   11111   11111   11111  x1  x1  x1   1
1               1       1  xxxxx1  x1   1
1   11111111111111111   111111111  x1   1
1       1               1       1  x1   1
111111111   11111111111111111   1  x1   1
1       1   1       1           1  xxx  1
1   1   1   1   1   1   11111   11111x  1
1   1       1   1       1       1xxxxx  1
1   111111111   111111111   11111x  11111
1               1           1   1x  1   1
111111111   11111   111111111   1x  1   1
1           1       1  xxxxxxxxxxx  1   1
11111   1111111111111  x1111111111111   1
1   1               1  x1  xxxxx        1
1   1111111111111   1  x1  x1  x111111111
1   1               1  xxxxx1  xxxxxxx  1
1   1   11111111111111111111111111111x  1
1       1                     xxxxxxxx  1
11111111111111111111111111111 x 111111111
